###########
#>      # #
# ##### # #
# #     # #
### ##### #
#   #    X#
# ### ### #
#     #   #
####### ###
#         #
###########