#################
#>    #   #     #
# ### # # # # # #
#     # #   # # #
# ########### # #
#   #     #   #X#
### # ### # ### #
#   # #   #   # #
# ### # ##### # #
#     #       # #
#################